Countries:
Afghanistan
Australia
Canada
Germany
Indonesia
Iran, Islamic Rep.
Iraq
Israel
Korea, Rep.
Pakistan 
Russian Federation
Singapore
Sweden
United Kingdom
United States
Vietnam


Series:
Military expenditure (current USD)	MS.MIL.XPND.CD
Current health expenditure per capita (current US$)	SH.XPD.CHEX.PC.CD
Gross national expenditure (current US$)	NE.DAB.TOTL.CD
Current education expenditure, primary (% of total expenditure in primary public institutions)	SE.XPD.CPRM.ZS
Current education expenditure, secondary (% of total expenditure in secondary public institutions)	SE.XPD.CSEC.ZS
Current education expenditure, tertiary (% of total expenditure in tertiary public institutions)	SE.XPD.CTER.ZS
Current education expenditure, total (% of total expenditure in public institutions)	SE.XPD.CTOT.ZS
Current health expenditure (% of GDP)	SH.XPD.CHEX.GD.ZS
Educational attainment, at least Bachelor's or equivalent, population 25+, female (%) (cumulative)	SE.TER.CUAT.BA.FE.ZS
Educational attainment, at least Bachelor's or equivalent, population 25+, male (%) (cumulative)	SE.TER.CUAT.BA.MA.ZS
Educational attainment, at least Bachelor's or equivalent, population 25+, total (%) (cumulative)	SE.TER.CUAT.BA.ZS
Government expenditure on education, total (% of GDP)	SE.XPD.TOTL.GD.ZS
Government expenditure on education, total (% of government expenditure)	SE.XPD.TOTL.GB.ZS
Gross national expenditure (% of GDP)	NE.DAB.TOTL.ZS
Labor force with advanced education (% of total working-age population with advanced education)	SL.TLF.ADVN.ZS
Labor force with advanced education, female (% of female working-age population with advanced education)	SL.TLF.ADVN.FE.ZS
Labor force with advanced education, male (% of male working-age population with advanced education)	SL.TLF.ADVN.MA.ZS
Military expenditure (% of GDP)	MS.MIL.XPND.GD.ZS
Military expenditure (% of general government expenditure)	MS.MIL.XPND.ZS
Coverage of social insurance programs (% of population)	per_si_allsi.cov_pop_tot
Current account balance (% of GDP)	BN.CAB.XOKA.GD.ZS
Educational attainment, at least Master's or equivalent, population 25+, female (%) (cumulative)	SE.TER.CUAT.MS.FE.ZS
Educational attainment, at least Master's or equivalent, population 25+, male (%) (cumulative)	SE.TER.CUAT.MS.MA.ZS
Educational attainment, at least Master's or equivalent, population 25+, total (%) (cumulative)	SE.TER.CUAT.MS.ZS
Educational attainment, Doctoral or equivalent, population 25+, female (%) (cumulative)	SE.TER.CUAT.DO.FE.ZS
Educational attainment, Doctoral or equivalent, population 25+, male (%) (cumulative)	SE.TER.CUAT.DO.MA.ZS
Educational attainment, Doctoral or equivalent, population 25+, total (%) (cumulative)	SE.TER.CUAT.DO.ZS
Electric power transmission and distribution losses (% of output)	EG.ELC.LOSS.ZS
Electricity production from coal sources (% of total)	EG.ELC.COAL.ZS
Electricity production from hydroelectric sources (% of total)	EG.ELC.HYRO.ZS
Electricity production from natural gas sources (% of total)	EG.ELC.NGAS.ZS
Electricity production from nuclear sources (% of total)	EG.ELC.NUCL.ZS
Electricity production from oil, gas and coal sources (% of total)	EG.ELC.FOSL.ZS
Electricity production from oil sources (% of total)	EG.ELC.PETR.ZS
Electricity production from renewable sources, excluding hydroelectric (% of total)	EG.ELC.RNWX.ZS
Energy imports, net (% of energy use)	EG.IMP.CONS.ZS
Expense (% of GDP)	GC.XPN.TOTL.GD.ZS
Exports of goods and services (% of GDP)	NE.EXP.GNFS.ZS
GDP growth (annual %)	NY.GDP.MKTP.KD.ZG
GDP per capita growth (annual %)	NY.GDP.PCAP.KD.ZG
GDP per capita (current US$)	NY.GDP.PCAP.CD
GDP (current US$)	NY.GDP.MKTP.CD
